脱	脫
媯	嬀
歎	嘆
粧	妝
衞	衛
贋	贗
湧	涌
蒍	蔿
稜	棱
偽	僞
閲	閱
兑	兌
氲	氳
榅	榲
卧	臥
潀	潨
説	說
蒀	蒕
台	臺
愠	慍
濕	溼
輼	轀
葱	蔥
鈎	鉤
涚	涗
煴	熅
枱	檯
踴	踊
缽	鉢
叁	叄
啟	啓
勛	勳
灶	竈
税	稅
皂	皁
溈	潙
核	覈
嫻	嫺
户	戶
宂	冗
敍	敘
鰛	鰮
巖	岩
媪	媼
韁	繮
蜕	蛻
敚	敓
眾	衆
悦	悅
温	溫
緼	縕
鋭	銳
藴	蘊
煙	菸
抬	擡
捝	挩
腽	膃
胄	冑
囱	囪
粽	糉
為	爲
痴	癡
裊	嫋
才	纔
鼈	鱉
痺	痹
枴	柺
揾	搵
醖	醞
棁	梲
