鯰	鮎
粽	糉
嫻	嫺
凶	兇
核	覈
蒍	蔿
稜	棱
偽	僞
麵	麪
峰	峯
眾	衆
湧	涌
床	牀
潀	潨
么	幺
汙	污
晒	曬
睪	睾
媯	嬀
為	爲
痴	癡
踴	踊
才	纔
著	着
痺	痹
啟	啓
洩	泄
灶	竈
群	羣
裡	裏
溈	潙
